#s#############
#..############
#..........####
##########....#
##########.##.#
####.......##.#
#....######.#t#
####.........##
#e.#......###n#
##.##......#..#
#..##.#######.#
#.#.#.........#
#.#.#####..####
#.............#
##g############